1111111111111111111111111111111111111111111111111111111111111111111111111111111111111111
1P00000000000000000000000000000000000000000000000000000000000000000000000000000000000001
100C000B0C00000000C000B0C000000C00000000C000000B0C00000000C00000000C0B0C000B0C0000000011
100000B00000B0000000000000B0000000000000B00000B0000000B00000B0C0B0C000B0C0000B0C00000011
100C000000C00000000C00000C0B0C0B00000C0B0C0B000000C0B0C0B0C0B0C000B0C000B0C000B0C0000011
10000000B000B000B000B000000B0C0B0C0000B00000B00000B0C0B0C0B0C0B00000B0C00000B0C000000011
100C000000C00000000C0B0C00000B0C0B0C000000C0B0C0B000000C0B0C0B0C0B000B0C000B0C0000001111
100000B0C000B0C000B0C0B000B0C00000B0C000B0C0B000B0C0B000B0C0B0C0B000B0C0B0C000B0C0000001
100C0B0C00000C0B0C0B0C0B0C0B0C000B0C0B0C000B0C0B0C000B0C0B0C0B0C0B0C0B0C0B0C0B0C00000001
10000000B0C0B0C0B0C0B0C0B0C000B0C0B0C0B00000B0C0B0C0B0C0B0C0B0C0B0C0B0C0B0C00000E0000001
1111111111111111111111111111111111111111111111111111111111111111111111111111111111111111
