111111111111111111111
100B01000000000010001
1111000111E111100C001
100001000000001110011
1000C00011100000000P1
111111111111111111111