11111111
1E1CP001
11100001
11111111