111111111111111111111111111111111111111111111
1B0000000000000000000B000000000000000000000B1
100000C00000000000000000000000000000000000001
10000000000C00000000000000C000000000000000001
100000000000000000000000000000000000000000001
1000000000000000000000000000000000C0000000001
1B00000C00000000000PEB000000000000000000000B1
100000000000000000000000000000000000000000001
1000000000C0000000000000000000000000000000001
100000000000000000000000000000000000000000001
10000000000000000000000C0000000000C0000000001
100000000000000000000000000000000000000000001
1B0000000000000C00000B000000000C00000000000B1
111111111111111111111111111111111111111111111